py=Python
java=Java
cpp=C++
cs=C#
html=HTML
css=CSS
js=JavaScript
php=PHP
xml=XML
json=JSON
csv=Comma_Separated_Values
txt=Plain_Text
md=Markdown
sql=SQL
sh=Shell_Script
bat=Batch_Script
yaml=YAML
yml=YAML
ini=Configuration_File
toml=TOML_Configuration
exe=Executable_File
dll=Dynamic_Link_Library
so=Shared_Object
o=Object_File
a=Static_Archive
lib=Library_File
class=Java_Bytecode
jar=Java_Archive
war=Web_Application_Archive
ear=Enterprise_Application_Archive
zip=ZIP_Archive
tar=TAR_Archive
gz=GZIP_Archive
bz2=BZIP2_Archive
xz=XZ_Archive
7z=7-Zip_Archive
rar=RAR_Archive
iso=ISO_Image
img=Disk_Image
dmg=Apple_Disk_Image
vhd=Virtual_Hard_Disk
vmdk=VMware_Virtual_Disk
qcow2=QEMU_Virtual_Disk
ova=Open_Virtual_Appliance
ovf=Open_Virtualization_Format
png=PNG_Image
jpg=JPEG_Image
jpeg=JPEG_Image
bmp=Bitmap_Image
gif=GIF_Image
tiff=TIFF_Image
psd=Photoshop_Document
ai=Adobe_Illustrator_File
svg=Scalable_Vector_Graphics
mp4=MPEG-4_Video
mkv=Matroska_Video
avi=Audio_Video_Interleave
wmv=Windows_Media_Video
flv=Flash_Video
mov=QuickTime_Video
mp3=MP3_Audio
wav=Waveform_Audio
ogg=Ogg_Vorbis_Audio
flac=Free_Lossless_Audio_Codec
aac=Advanced_Audio_Codec
wma=Windows_Media_Audio
doc=Microsoft_Word_Document
docx=Microsoft_Word_Open_XML_Document
ppt=Microsoft_PowerPoint_Presentation
pptx=Microsoft_PowerPoint_Open_XML_Presentation
xls=Microsoft_Excel_Spreadsheet
xlsx=Microsoft_Excel_Open_XML_Spreadsheet
pdf=Portable_Document_Format
epub=Electronic_Publication
mobi=Mobipocket_eBook
azw=Amazon_Kindle_eBook
rtf=Rich_Text_Format
odt=OpenDocument_Text
ods=OpenDocument_Spreadsheet
odp=OpenDocument_Presentation
odg=OpenDocument_Drawing
key=Apple_Keynote_Presentation
pages=Apple_Pages_Document
numbers=Apple_Numbers_Spreadsheet
tex=LaTeX_Document
bib=BibTeX_Bibliography
cls=LaTeX_Class_File
sty=LaTeX_Style_File
log=Log_File
conf=Configuration_File
rc=Run_Commands_Configuration
ps1=PowerShell_Script
pl=Perl_Script
rb=Ruby_Script
go=Go_Source_File
swift=Swift_Source_File
kt=Kotlin_Source_File
rs=Rust_Source_File
ts=TypeScript
tsx=TypeScript_JSX
jsx=JavaScript_JSX
vbs=VBScript_File
asp=Active_Server_Pages
jsp=Java_Server_Pages
cfm=ColdFusion_Markup_Language
aspx=Active_Server_Pages_Extended
scss=Sass_CSS
less=LESS_CSS_Preprocessor
lock=Lock_File
bak=Backup_File
old=Old_Backup_File
tmp=Temporary_File
